# Common Typing Mistakes to Practice

teh quick brown fox (should be: the)
I recieved your email (should be: received)
seperate meeting (should be: separate)
---

Accomodation is necessary (should be: Accommodation)
for thier comfort (should be: their)
definately not (should be: definitely)
---

independance day (should be: independence)
responsability (should be: responsibility)
goverment official (should be: government)
---

noticable change (should be: noticeable)
ocurrence (should be: occurrence)
embarass (should be: embarrass)
---

alot of work (should be: a lot)
allready finished (should be: already)
excersise routine (should be: exercise)
---

Febuary (should be: February)
Wensday (should be: Wednesday)
Calender (should be: Calendar)
---

beggining (should be: beginning)
comittment (should be: commitment)
tommorow (should be: tomorrow)
---

accomodate (should be: accommodate)
publically (should be: publicly)
priviledge (should be: privilege)
---

neccessary (should be: necessary)
occassion (should be: occasion)
maintainance (should be: maintenance)
---

consistant (should be: consistent)
persistant (should be: persistent)
resistent (should be: resistant)
